반갑다=Быть радостным
알겠어요?=Вам понятно?
같이=Вместе
저분=Вон тот человек
모두=Все Итого
어디=Где?
눈=Глаз
주다=Дайте
나무=Дерево
싸다=Дешевый
친구=Друг
먹다=Есть
질문 있어요?=Есть у вас вопросы?
밤=Желудь
여기=Здесь
안녱하세요?=Здраствуйте
미안니하다=Извините
죄송합니다=Извините привлечь внимание
영화=Кино
중국어=Китайский язык
배=Корабль
한국어=Корейский язык
달=Луна
음악=Музыка
우리=Мы
코=Нос
좋아하다=Нравится
책을 펴세요=Откройте книгу
약속=Обещание
잭을 보세요=Посмотрите в книгу
물건=Предметы
새다=Протекать
로=При помощи чего
몇=Сколько
얼마나=Сколько количество
얼마에요?=Сколько стоит
고맙습니다=Спасибо
감사합니다=Спасибо
안녕히 계세요=Счастливо оставаться
안녕히 가세요=Счастливого пути
그분=Тот человек
무엇을 드릴까요?=Чем могу помочь?
뭐 해요?=Что делаете?
무엇=Что?
이분=Этот человек
괜찮다=Нормальный
수업=Урок
회의=Собрание
정말=Действительно
시험=Экзамен
왜=Почему? Зачем?
많이=Много
재미있다=Интересный
어렵다=Сложный, трудный
이유=Причина
배우다=Изучать
지난=Прошлый, прошедший
이주=Очень
쉽다=Легкий
말하기=Разговор
노래=Песня
시작라다=Начинать
잘하다=Уметь хорошо что-то делать
